1111111111111
11110000000C1
1000011111011
1P1111E000011
1111111111111