1111111111111111111111111111111111
1E0000000000000C00000C000001010001
1010010100100000101001000000010101
1010010010101000100100000001010001
1P1000000C00C0000000000000000000C1
1111111111111111111111111111111111